0 0 0 0 0 0 0 1 12 0 0 0 0 0 0 9
0 0 0 0 0 0 0 0 1 0 0 0 17 17 0 9
0 0 0 0 0 0 0 2 0 0 0 0 0 0 0 9
13 14 0 0 0 0 0 2 12 0 0 0 0 0 0 9
15 16 0 0 0 0 0 0 1 0 0 0 0 0 0 9
13 14 0 0 0 8 8 8 8 8 8 0 0 0 0 9
15 16 0 0 0 8 8 8 8 8 8 0 0 0 0 9
0 0 0 0 0 8 8 8 8 8 8 0 0 0 0 9
0 0 0 0 0 0 0 0 0 0 0 0 0 0 0 9
0 0 0 0 0 0 0 0 0 0 0 0 0 0 0 9