9 10 0 0 0 0 1 0 0 0 0 0 0 0 14 15
11 12 0 0 0 0 2 1 0 0 0 0 0 0 14 15
9 10 0 0 0 0 0 8 0 0 0 0 0 0 14 15
11 12 0 0 0 0 1 0 0 0 0 0 0 0 14 15
0 0 0 0 0 0 0 0 8 0 0 0 0 0 14 15
9 10 0 0 0 0 13 13 13 0 0 0 0 0 14 15
11 12 0 0 0 0 0 0 0 0 0 0 0 0 14 15
0 0 0 0 0 0 0 0 0 0 0 0 0 0 14 15
14 14 14 14 14 14 14 14 14 14 14 14 14 14 14 15
17 17 17 17 17 17 17 17 17 17 17 17 17 17 17 16