0 0 0 0 0 0 0 0 0 0 0 0 0 0 0 0
0 9 10 0 0 0 0 0 0 0 0 0 0 0 0 0
0 11 12 0 0 0 0 0 0 0 0 0 0 0 0 0
0 0 0 0 0 0 0 0 0 0 0 0 0 0 0 0
0 0 0 0 0 0 0 0 0 0 0 0 0 0 0 0
0 0 0 13 13 0 0 0 0 0 0 0 0 0 0 0
0 0 0 0 0 0 0 0 0 0 9 10 0 0 0 0
0 0 0 0 0 0 0 0 0 0 11 12 0 0 0 0
0 0 0 0 0 0 0 0 0 0 0 0 0 0 0 0
17 17 17 17 17 17 17 17 17 17 17 17 17 17 17 17