0 0 0 0 0 0 0 0 0 0 0 0 0 0 0 15
0 0 0 0 0 0 0 0 0 0 0 0 0 0 0 15
0 0 9 10 0 0 0 0 0 0 0 0 0 0 0 15
0 0 11 12 0 0 0 0 0 0 0 0 0 0 0 15
0 0 0 0 0 0 0 9 10 0 0 0 0 0 0 15
0 0 0 0 0 0 0 11 12 0 0 0 0 0 0 15
0 0 0 0 0 0 0 0 0 0 0 0 0 0 0 15
0 0 0 0 0 0 0 0 0 0 0 0 0 0 0 15
0 0 0 0 0 0 0 0 0 0 0 0 0 0 0 15
17 17 17 17 17 17 17 17 17 17 17 17 17 17 17 18