2 3 3 4 3 3 5 18 18 6 3 3 4 4 3 7
1 18 18 18 18 18 18 18 18 18 18 18 18 18 18 8
1 18 18 18 18 18 18 18 18 18 18 18 18 18 18 8
0 18 18 18 18 18 18 18 18 18 18 18 18 18 18 9
18 18 18 18 18 18 18 18 18 18 18 18 18 18 18 18
18 18 18 18 18 18 18 18 18 18 18 18 18 18 18 18
17 18 18 18 18 18 18 18 18 18 18 18 18 18 18 10
1 18 18 18 18 18 18 18 18 18 18 18 18 18 18 8
1 18 18 18 18 18 18 18 18 18 18 18 18 18 18 8
16 13 13 13 12 13 15 18 18 14 13 13 13 12 13 11