25 24 24 24 23 24 39 0 0 40 23 23 24 24 23 32
26 0 0 0 0 0 0 0 0 0 0 0 0 0 0 27
26 0 0 9 10 0 0 0 0 0 0 0 0 0 0 27
33 0 0 11 12 0 0 0 0 0 0 0 0 0 0 27
0 0 0 0 0 0 0 0 0 0 0 0 0 0 0 27
0 0 0 0 0 0 0 0 0 0 0 0 0 0 0 27
34 0 0 0 0 0 0 0 0 0 0 9 10 0 0 27
26 0 0 0 0 0 0 0 0 0 0 11 12 0 0 27
26 0 0 0 0 0 0 0 0 0 0 0 0 0 0 27
30 29 29 29 28 28 37 0 0 38 29 29 28 28 28 31