23 25 24 24 23 24 23 23 23 23 24 24 24 24 25 23
0 0 0 0 0 0 0 0 0 0 0 0 0 0 0 0
0 0 0 0 0 0 0 0 0 0 0 0 0 0 0 0
0 0 0 0 0 0 0 0 0 0 0 0 0 0 0 0
0 0 0 0 0 0 0 0 0 0 0 0 0 0 0 0
0 0 0 0 0 0 13 13 13 0 0 0 0 0 0 0
0 0 0 0 0 0 0 9 10 0 0 0 0 0 0 0
0 0 0 0 0 0 0 11 12 0 0 0 0 0 0 0
0 0 0 0 0 0 0 0 0 0 0 0 0 0 0 0
0 0 0 0 0 0 0 0 0 0 0 0 0 0 0 0