23 23 24 24 24 24 23 23 24 23 23 23 24 24 23 23
0 0 0 0 0 0 0 0 0 0 0 0 0 0 0 0
0 0 0 0 0 0 0 0 0 0 0 0 0 0 0 0
0 0 0 0 0 0 0 0 0 0 0 9 10 0 0 0
0 0 0 0 0 0 0 0 0 0 0 11 12 0 0 0
0 0 0 13 13 13 0 0 0 0 0 0 0 0 0 0
0 0 0 21 22 20 0 0 0 0 0 0 0 0 0 0
0 0 0 19 14 15 0 0 0 0 0 0 0 0 0 0
0 0 0 18 17 16 0 0 0 0 0 0 0 0 0 0
0 0 0 0 0 0 0 0 0 0 0 0 0 0 0 0