21 22 22 22 22 22 22 22 22 22 22 22 22 22 22 22
19 0 0 0 0 0 0 0 0 0 0 0 0 0 0 0
19 0 0 0 0 0 0 0 0 13 13 13 0 0 0 0
19 0 0 0 0 0 0 0 0 0 0 0 0 0 0 0
19 0 0 0 0 0 2 1 0 0 0 0 0 0 0 0
19 0 0 0 0 0 1 2 0 0 0 0 0 0 0 0
19 0 0 0 0 0 0 0 0 0 0 0 0 0 0 0
19 0 0 9 10 0 0 0 0 0 0 0 0 0 0 0
19 0 0 11 12 0 0 0 0 0 0 0 0 0 0 0
19 0 0 0 0 0 0 0 0 0 0 0 0 0 0 0