25 24 24 24 23 24 24 23 24 24 23 23 24 24 23 32
26 0 0 0 0 0 0 0 0 0 0 0 0 0 0 27
26 0 0 0 0 0 0 0 0 0 0 0 0 0 0 27
26 0 0 0 0 0 9 10 0 0 0 0 0 0 0 35
26 0 0 0 0 0 11 12 0 0 0 0 0 0 0 0
26 0 0 0 0 0 0 0 0 0 0 0 0 0 0 0
26 0 0 0 0 0 9 10 0 0 0 0 0 0 0 36
26 0 0 0 0 0 11 12 0 0 0 0 0 0 0 27
26 0 0 0 0 0 0 0 0 0 0 0 0 0 0 27
30 29 29 29 28 28 37 0 0 38 29 29 28 28 28 31